##########################
#1            #         2#
#    #        # ####     #
#    #        #          #
#    #        #          #
#    #        #          #
#             #          #
#             #          #
##########################
