##########################
#1            #2         #
#    #        # ####     #
#    #        #          #
#    #        #          #
#    #        #          #
#             #          #
#             #          #
##########################
