###############
#             # 
#    #        #
#    #        #
#    #  P     #
#    #        #
#             #
#             #
###############
