###############
#P            # 
#    #        #
#    #        #
#    #        #
#    #        #
#             #
#             #
###############
