##########################
#1            #         2#
#    X        # ####     #
#    X        #          #
#    X        #          #
#    X        #          #
#             #          #
#             #          #
##########################
