    ######  ####
    #+#  #  ##+#
    #X#  #  ## #
    #X#  #  ## #
    #X#  #  ## #
#####S#  ##### #
#D    #  ##    #
# # #X#  ## ## #
# #   #  ## ## #
#####1#  ##T##2#
################
