    ######  ####
    #+#  #  ##+#
    #X#  #  ## #
    #X#  #  ## #
    #X#  #  ## #
#####C#  ##### #
#     #  ##    #
# # #X#  ## ## #
# #   #  ## ## #
##### #  ##A## #
##### #  ##### #
#####1#  #####2#
################