    ######  ####
    #+#  #  ##+#
    #X#  #  ## #
    #X#  #  ## #
    #X#  #  ## #
#####S#  ##### #
#D    #  ##    #
# # #X#  ## ## #
# #   #  ## ## #
##### #  ##A## #
##### #  ##### #
#####1#  #####2#
################