###########
#+ T # X+X#
#    # XXX#
#    #  S #
#D   #    #
#P   # #  #
# 1  #  2 #
###########
