################
#   #B#   ###  #
#   # # ###B#  #
#   #X# #S#D####
### #S# # #DDDT#
#T### # # # #S##
# #DDD# #   ####
#   #D### ###  #
###DD  S# XB#  #
# ### ### ###  #
#   # # # #    #
#   # # # #    #
################