##################
#                #
#                #
#                #
#                #
#                #
#                #
#       S        #
#                #
#                #
#                #
#                #
#       1     2  #
##################