###########
#+ T # X+X#
#    # XXX#
#    #  S #
#    #    #
#    # #  #
# 1  #  2 #
###########
@ 8 3 2 L 3 1